C 0, 0, 71     
F 255, 25, 255

NO ./textures/employee64.xpm
WE ./textures/innerglass64.xpm
EA ./textures/window64.xpm
SO ./textures/plainwall64.xpm

11111111111111111111
      11000001 11111
11111111111111111111
10010N1
10000001
10000001
10000011
10000001111111111111
1000000000000000001
111111111111111111111
