C 0, 0, 71     
F 255, 25, 251

NO ./textures/employee64.xpm
WE ./textures/innerglass64.xpm
EA ./textures/window64.xpm
SO ./textures/plainwall64.xpm

11111111111111111111
      11000000111111
11111111111111111111
10010S0011
10000001
10000001
10000011
1000000111111111
1000000000000000111
111111111111111111111
